#############################################
#   # #   #       # #s  #   #               #
# # # # # # ##### # ### # # # ############# #
# #   # # # #     # #   # # # #     #     # #
# ### # # # # ##### # ##### # # ### ##### # #
# #   # # # #       # #       # # # #       #
### ### # # ####### # ######### # # # #######
#   #   # #     #   #         # #   #       #
# ### ### ##### # ########### # # ######### #
#   # # # #   # # #   # #   # #e#           #
### # # # # ### # ### # # # # ############# #
#   #   # #     #   #   # # #   #   #   #   #
# ##### # ######### ### # ##### ### # ### ###
# #     #         #   #   #     #   #   #   #
# # ############# ### # ### ##### # ### ### #
#   #                             #         #
#############################################
